/â°ïù,ècïù,îwåi,âπäy,ÉXÉNÉçÅ[Éã,
 60, 15, 1, 1, 0,
 307, 307, 307, 307, 307, 307, 307, 307, 307, 307, 307, 307, 307, 307, 307, 307, 307, 307, 307, 307, 307, 307, 307, 307, 307, 307, 307, 307, 307, 307, 307, 307, 307, 307, 307, 307, 307, 307, 307, 307, 307, 307, 307, 307, 307, 307, 307, 307, 307, 307, 307, 307, 307, 307, 307, 307, 307, 307, 307, 307,
 307, 307, 307, 307, 307, 307, 307, 307, 307, 307, 307, 307, 307, 307, 307, 307, 307, 307, 307, 307, 307, 307, 307, 307, 307, 307, 307, 307, 307, 307, 307, 307, 307, 307, 307, 307, 307, 307, 307, 307, 307, 307, 307, 307, 307, 307, 307, 307, 307, 307, 307, 307, 307, 307, 307, 307, 307, 307, 307, 307,
 307, 307, 307, 307, 307, 307, 307, 307, 307, 307, 307, 307, 307, 307, 0, 0, 0, 0, 307, 307, 307, 307, 307, 307, 307, 0, 307, 307, 307, 307, 0, 0, 0, 0, 0, 0, 0, 0, 0, 0, 0, 0, 0, 0, 0, 0, 0, 0, 0, 0, 0, 0, 0, 0, 0, 0, 0, 0, 0, 307,
 307, 307, 307, 307, 307, 307, 307, 307, 307, 307, 0, 0, 0, 0, 0, 0, 11009, 0, 307, 307, 307, 307, 307, 307, 0, 0, 0, 307, 307, 307, 0, 0, 0, 0, 0, 0, 0, 0, 0, 0, 0, 0, 0, 0, 0, 0, 0, 0, 0, 0, 0, 0, 0, 0, 0, 0, 0, 0, 0, 307,
 307, 307, 307, 307, 307, 307, 307, 307, 307, 307, 0, 0, 0, 0, 0, 0, 0, 0, 307, 307, 307, 307, 307, 307, 0, 0, 0, 307, 307, 307, 0, 0, 0, 0, 0, 0, 0, 0, 0, 0, 0, 0, 0, 0, 0, 0, 0, 0, 0, 0, 0, 0, 0, 0, 0, 0, 0, 0, 0, 307,
 307, 307, 307, 307, 307, 0, 0, 0, 0, 0, 0, 0, 0, 0, 0, 0, 0, 0, 307, 307, 307, 307, 307, 0, 0, 0, 0, 0, 307, 0, 0, 0, 0, 0, 0, 0, 0, 0, 0, 0, 0, 0, 0, 0, 0, 0, 0, 0, 0, 0, 0, 0, 0, 0, 0, 0, 0, 0, 0, 307,
 307, 307, 307, 307, 307, 0, 0, 0, 0, 0, 0, 0, 0, 0, 0, 0, 0, 0, 0, 0, 0, 0, 0, 0, 0, 901, 0, 0, 11009, 0, 0, 0, 0, 0, 11002, 0, 0, 0, 0, 0, 0, 0, 0, 11009, 0, 0, 0, 0, 0, 0, 0, 0, 0, 0, 0, 0, 0, 0, 0, 307,
 0, 0, 0, 0, 0, 0, 0, 0, 0, 0, 0, 0, 0, 0, 307, 307, 0, 0, 0, 0, 0, 0, 11001, 0, 0, 307, 0, 0, 0, 0, 0, 307, 307, 307, 307, 307, 0, 0, 0, 0, 0, 0, 0, 0, 0, 0, 0, 0, 0, 0, 0, 0, 307, 307, 307, 307, 31503, 31503, 31503, 307,
 0, 0, 0, 0, 0, 0, 0, 0, 0, 0, 0, 0, 0, 0, 307, 307, 307, 307, 307, 307, 307, 307, 307, 307, 307, 307, 307, 307, 307, 307, 307, 307, 307, 307, 307, 307, 307, 307, 0, 0, 0, 0, 5504, 5504, 5504, 0, 0, 0, 0, 0, 0, 307, 307, 0, 0, 0, 0, 0, 0, 307,
 0, 0, 0, 0, 0, 0, 0, 0, 0, 0, 0, 0, 0, 307, 307, 307, 307, 307, 307, 307, 307, 307, 307, 307, 307, 307, 307, 307, 307, 307, 307, 307, 307, 307, 307, 307, 307, 307, 307, 307, 0, 0, 0, 0, 0, 0, 0, 0, 0, 0, 0, 307, 0, 0, 0, 0, 0, 0, 0, 307,
 0, 999, 0, 0, 0, 0, 0, 0, 0, 0, 0, 0, 0, 307, 307, 307, 307, 307, 307, 307, 307, 307, 307, 307, 307, 307, 307, 307, 307, 307, 307, 307, 307, 307, 307, 307, 307, 307, 307, 307, 500, 0, 0, 0, 0, 0, 0, 0, 0, 0, 0, 307, 0, 0, 0, 0, 0, 12001, 0, 307,
 0, 0, 0, 0, 0, 0, 0, 0, 0, 0, 307, 307, 307, 307, 307, 307, 307, 307, 307, 307, 307, 307, 307, 307, 307, 307, 307, 307, 307, 307, 307, 307, 307, 307, 307, 307, 307, 307, 307, 307, 0, 0, 0, 501, 501, 501, 501, 501, 501, 501, 501, 307, 33503, 33503, 33503, 307, 307, 307, 307, 307,
 307, 307, 307, 307, 307, 307, 307, 307, 0, 0, 307, 307, 307, 307, 307, 307, 307, 307, 307, 307, 307, 307, 307, 307, 307, 307, 307, 307, 307, 307, 307, 307, 307, 307, 307, 307, 307, 307, 307, 307, 501, 501, 501, 307, 307, 307, 307, 307, 307, 307, 307, 307, 0, 0, 0, 0, 0, 801, 0, 0,
 307, 307, 307, 307, 307, 307, 307, 307, 0, 0, 307, 307, 307, 307, 307, 307, 307, 307, 307, 307, 307, 307, 307, 307, 307, 307, 307, 307, 307, 307, 307, 307, 307, 307, 307, 307, 307, 307, 307, 307, 307, 307, 307, 307, 307, 307, 307, 307, 307, 307, 307, 307, 0, 0, 0, 0, 0, 0, 0, 0,
 307, 307, 307, 307, 307, 307, 307, 307, 0, 0, 307, 307, 307, 307, 307, 307, 307, 307, 307, 307, 307, 307, 307, 307, 307, 307, 307, 307, 307, 307, 307, 307, 307, 307, 307, 307, 307, 307, 307, 307, 307, 307, 307, 307, 307, 307, 307, 307, 307, 307, 307, 307, 307, 307, 307, 307, 307, 307, 307, 307,
